1
1
8
8
########
###___##
#_$_#_##
#_#__._#
#____#_#
##_#___#
##@__###
########
