10
8
9
13
#############
###___#___###
##_$#_#_#$###
#___#._.#___#
#_$_*.@.*_$_#
#___#._.#___#
###$#_#_#$_##
###___#___###
#############
