2
3
7
7
#######
#._.###
#.#$$_#
#___@_#
#_$#__#
##___##
#######
