3
4
6
17
#################
#__#__#__#__#___#
#.$___#__#.$____#
#__#.$_.$___#___#
#_@#__#__#__#___#
#################
