4
3
9
8
########
####__##
#__$__##
#_#$#__#
#__$___#
#.###__#
#.####_#
#._@___#
########
