5
4
7
9
#########
#__###__#
#_$_*_$_#
#___+___#
###_.$###
###_._###
#########
