7
6
9
9
#########
######__#
##_$_$__#
##.#_#._#
##_$@$_##
##.#_#.##
#__*_*__#
#___#___#
#########
