9
5
9
10
##########
######___#
##_$_._#_#
##_#_$$__#
##_##_#_##
#__$.$._##
#_##___###
#__.@.####
##########
